{
  "levelId": 1,
  "tileMap": [
    [0, 0, 1, 1, 1, 1, 1, 1, 1, 1, 1, 1, 1, 3, 1],
    [0, 1, 1, 1, 1, 1, 1, 1, 1, 1, 1, 1, 1, 3, 1],
    [1, 1, 1, 1, 1, 1, 1, 1, 1, 1, 1, 1, 1, 3, 1],
    [1, 1, 1, 1, 1, 1, 1, 1, 1, 1, 1, 1, 1, 3, 1],
    [1, 1, 1, 1, 1, 1, 1, 1, 1, 1, 1, 1, 1, 3, 1],
    [1, 1, 1, 1, 1, 0, 0, 1, 1, 1, 1, 1, 1, 3, 1],
    [1, 1, 1, 1, 1, 4, 4, 1, 1, 1, 1, 1, 1, 3, 1],
    [1, 1, 1, 1, 1, 4, 4, 1, 1, 1, 1, 1, 1, 5, 1],
    [1, 1, 1, 1, 1, 1, 1, 1, 1, 1, 1, 1, 1, 3, 1],
    [1, 1, 1, 1, 1, 1, 1, 1, 1, 1, 1, 1, 1, 3, 1],
    [1, 1, 1, 1, 1, 1, 1, 1, 1, 1, 1, 1, 1, 3, 1],
    [1, 1, 1, 1, 1, 1, 1, 1, 1, 1, 1, 1, 1, 3, 1],
    [1, 1, 1, 1, 1, 1, 1, 1, 1, 1, 1, 1, 1, 3, 1],
    [2, 2, 1, 1, 1, 1, 1, 1, 1, 1, 1, 1, 1, 3, 1],
    [2, 2, 2, 1, 1, 1, 1, 1, 1, 1, 1, 1, 1, 3, 1]
  ],
  "start": {
    "tx": 3,
    "ty": 3
  },
  "sprites": [
    {
      "type": 0,
      "tx": 10,
      "ty": 1
    },
    {
      "type": 0,
      "tx": 1,
      "ty": 12
    }
  ]
}